DATE,Organic Milk,Creamy Milk,Flavoured Milk,Raw Milk,Total
01-01-2014,33,46,40,657,776
02-01-2014,35,50,43,657,785
03-01-2014,36,45,41,657,779
04-01-2014,32,41,37,658,768
05-01-2014,24,38,31,658,751
06-01-2014,22,39,31,658,750
07-01-2014,28,45,37,658,768
08-01-2014,30,41,36,659,766
09-01-2014,29,42,36,659,766
10-01-2014,30,47,39,659,775
11-01-2014,32,47,40,659,778
12-01-2014,30,47,39,659,775
13-01-2014,29,42,36,659,766
14-01-2014,31,47,39,659,776
15-01-2014,35,51,43,659,788
16-01-2014,35,55,45,700,835
17-01-2014,42,57,50,700,849
18-01-2014,38,54,46,700,838
19-01-2014,37,51,44,700,832
20-01-2014,36,53,45,659,793
21-01-2014,40,55,48,659,802
22-01-2014,31,44,38,659,772
23-01-2014,31,46,39,659,775
24-01-2014,39,54,47,659,799
25-01-2014,41,62,52,659,814
26-01-2014,42,58,50,659,809
27-01-2014,38,51,45,659,793
28-01-2014,29,39,34,658,760
29-01-2014,30,36,33,658,757
30-01-2014,28,39,34,658,759
31-01-2014,33,42,38,658,771
01-02-2014,35,50,43,657,785
02-02-2014,37,49,43,657,786
03-02-2014,36,50,43,657,786
04-02-2014,36,55,46,656,793
05-02-2014,38,53,46,656,793
06-02-2014,39,49,44,655,787
07-02-2014,39,52,46,655,792
08-02-2014,37,52,45,655,789
09-02-2014,34,57,46,654,791
10-02-2014,36,54,45,654,789
11-02-2014,34,52,43,653,782
12-02-2014,35,52,44,653,784
13-02-2014,35,49,42,652,778
14-02-2014,36,48,42,652,778
15-02-2014,38,55,47,651,791
16-02-2014,36,46,41,651,774
17-02-2014,36,43,40,650,769
18-02-2014,37,45,41,649,772
19-02-2014,35,46,41,649,771
20-02-2014,33,47,40,648,768
21-02-2014,34,48,41,647,770
22-02-2014,34,48,41,647,770
23-02-2014,33,48,41,646,768
24-02-2014,33,50,42,646,771
25-02-2014,33,47,40,645,765
26-02-2014,36,50,43,644,773
27-02-2014,36,55,46,643,780
28-02-2014,36,57,47,643,783
01-03-2014,41,55,48,642,786
02-03-2014,31,45,38,641,755
03-03-2014,31,42,37,640,750
04-03-2014,34,43,39,640,756
05-03-2014,33,46,40,639,758
06-03-2014,35,46,41,638,760
07-03-2014,34,54,44,637,769
08-03-2014,34,43,39,637,753
09-03-2014,36,47,42,636,761
10-03-2014,32,47,40,635,754
11-03-2014,31,49,40,634,754
12-03-2014,29,50,40,633,752
13-03-2014,33,55,44,632,764
14-03-2014,36,51,44,632,763
15-03-2014,32,48,40,631,751
16-03-2014,31,49,40,630,750
17-03-2014,36,53,45,629,763
18-03-2014,35,53,44,628,760
19-03-2014,35,53,44,627,759
20-03-2014,33,48,41,626,748
21-03-2014,30,48,39,626,743
22-03-2014,30,43,37,625,735
23-03-2014,32,45,39,624,740
24-03-2014,31,51,41,623,746
25-03-2014,34,53,44,622,753
26-03-2014,35,55,45,621,756
27-03-2014,31,46,39,620,736
28-03-2014,29,43,36,620,728
29-03-2014,32,39,36,619,726
30-03-2014,32,41,37,618,728
31-03-2014,31,42,37,617,727
01-04-2014,34,45,40,616,735
02-04-2014,33,52,43,615,743
03-04-2014,36,51,44,614,745
04-04-2014,31,50,41,614,736
05-04-2014,31,51,41,613,736
06-04-2014,35,49,42,612,738
07-04-2014,35,49,42,611,737
08-04-2014,35,52,44,610,741
09-04-2014,36,53,45,610,744
10-04-2014,35,55,45,609,744
11-04-2014,37,56,47,608,748
12-04-2014,36,52,44,607,739
13-04-2014,32,49,41,606,728
14-04-2014,31,50,41,606,728
15-04-2014,36,53,45,605,739
16-04-2014,40,59,50,604,753
17-04-2014,42,58,50,603,753
18-04-2014,43,60,52,602,757
19-04-2014,43,60,52,602,757
20-04-2014,41,57,49,601,748
21-04-2014,40,54,47,600,741
22-04-2014,38,58,48,600,744
23-04-2014,41,58,50,559,708
24-04-2014,41,59,50,558,708
25-04-2014,43,59,51,558,711
26-04-2014,45,62,54,557,718
27-04-2014,42,53,48,556,699
28-04-2014,40,53,47,556,696
29-04-2014,39,53,46,555,693
30-04-2014,37,50,44,554,685
01-05-2014,36,53,45,554,688
02-05-2014,38,51,45,553,687
03-05-2014,36,55,46,553,690
04-05-2014,36,55,46,552,689
05-05-2014,40,54,47,552,693
06-05-2014,40,58,49,551,698
07-05-2014,42,60,51,550,703
08-05-2014,42,61,52,550,705
09-05-2014,44,59,52,550,705
10-05-2014,42,56,49,549,696
11-05-2014,40,56,48,549,693
12-05-2014,38,55,47,548,688
13-05-2014,38,56,47,548,689
14-05-2014,40,55,48,547,690
15-05-2014,41,58,50,547,696
16-05-2014,44,60,52,547,703
18-05-2014,43,60,52,546,701
19-05-2014,44,60,52,546,702
20-05-2014,44,62,53,545,704
21-05-2014,47,62,55,545,709
22-05-2014,44,59,52,545,700
23-05-2014,41,58,50,545,694
24-05-2014,39,57,48,544,688
25-05-2014,38,52,45,544,679
26-05-2014,36,47,42,544,669
27-05-2014,35,49,42,544,670
28-05-2014,35,51,43,544,673
29-05-2014,34,53,44,543,674
30-05-2014,36,55,46,543,680
31-05-2014,35,51,43,543,672
01-06-2014,34,53,44,543,674
02-06-2014,36,48,42,543,669
03-06-2014,38,53,46,543,680
04-06-2014,37,53,45,543,678
05-06-2014,40,55,48,543,686
06-06-2014,35,52,44,543,674
07-06-2014,36,53,45,543,677
08-06-2014,42,54,48,543,687
09-06-2014,44,57,51,543,695
10-06-2014,43,60,52,543,698
11-06-2014,42,55,49,543,689
12-06-2014,37,53,45,543,678
13-06-2014,35,57,46,543,681
14-06-2014,37,62,50,544,693
15-06-2014,42,60,51,544,697
16-06-2014,41,58,50,544,693
17-06-2014,37,52,45,544,678
18-06-2014,36,51,44,544,675
19-06-2014,40,57,49,544,690
20-06-2014,39,52,46,545,682
21-06-2014,35,48,42,545,670
22-06-2014,37,53,45,545,680
23-06-2014,41,60,51,545,697
24-06-2014,42,60,51,545,698
25-06-2014,45,62,54,546,707
26-06-2014,48,64,56,546,714
27-06-2014,47,60,54,546,707
28-06-2014,47,59,53,546,705
29-06-2014,45,61,53,547,706
30-06-2014,43,61,52,547,703
01-07-2014,45,62,54,547,708
02-07-2014,47,61,54,548,710
03-07-2014,48,66,57,548,719
04-07-2014,47,65,56,548,716
05-07-2014,43,61,52,549,705
06-07-2014,40,58,49,549,696
07-07-2014,40,56,48,549,693
08-07-2014,44,55,50,550,699
09-07-2014,43,59,51,550,703
10-07-2014,43,62,53,550,708
11-07-2014,43,62,53,551,709
12-07-2014,42,61,52,551,706
13-07-2014,40,56,48,551,695
14-07-2014,41,51,46,552,690
15-07-2014,38,55,47,552,692
16-07-2014,39,52,46,553,690
17-07-2014,39,59,49,553,700
18-07-2014,37,59,48,553,697
19-07-2014,41,56,49,554,700
20-07-2014,41,51,46,554,692
21-07-2014,42,58,50,554,704
22-07-2014,43,52,48,555,698
23-07-2014,44,61,53,555,713
24-07-2014,45,62,54,556,717
25-07-2014,44,64,54,556,718
26-07-2014,42,57,50,556,705
27-07-2014,38,54,46,557,695
28-07-2014,35,58,47,557,697
29-07-2014,34,53,44,557,688
30-07-2014,38,56,47,558,699
31-07-2014,39,55,47,558,699
01-08-2014,44,62,53,558,717
02-08-2014,42,60,51,559,712
03-08-2014,43,60,52,559,714
04-08-2014,44,64,54,559,721
05-08-2014,43,61,52,600,756
06-08-2014,40,60,50,600,750
07-08-2014,41,50,46,600,737
08-08-2014,41,52,47,601,741
09-08-2014,39,57,48,601,745
10-08-2014,38,53,46,601,738
11-08-2014,39,56,48,602,745
12-08-2014,40,58,49,602,749
13-08-2014,41,62,52,602,757
14-08-2014,44,63,54,603,764
15-08-2014,45,63,54,603,765
16-08-2014,42,62,52,603,759
17-08-2014,39,58,49,603,749
18-08-2014,38,57,48,604,747
19-08-2014,36,55,46,604,741
20-08-2014,38,54,46,604,742
21-08-2014,40,56,48,604,748
22-08-2014,39,57,48,605,749
23-08-2014,43,60,52,605,760
24-08-2014,42,59,51,605,757
25-08-2014,41,60,51,605,757
26-08-2014,41,56,49,606,752
27-08-2014,40,55,48,606,749
28-08-2014,39,56,48,606,749
29-08-2014,38,55,47,606,746
30-08-2014,44,59,52,607,762
31-08-2014,42,60,51,607,760
01-09-2014,38,55,47,607,747
02-09-2014,42,59,51,607,759
03-09-2014,42,60,51,607,760
04-09-2014,44,58,51,608,761
05-09-2014,44,61,53,608,766
06-09-2014,41,58,50,608,757
07-09-2014,39,54,47,608,748
08-09-2014,39,53,46,608,746
09-09-2014,39,54,47,609,749
10-09-2014,40,55,48,609,752
11-09-2014,42,56,49,609,756
12-09-2014,39,60,50,609,758
13-09-2014,41,60,51,609,761
14-09-2014,42,59,51,610,762
15-09-2014,43,57,50,610,760
16-09-2014,40,52,46,610,748
17-09-2014,39,53,46,610,748
18-09-2014,37,55,46,610,748
19-09-2014,40,54,47,611,752
20-09-2014,41,51,46,611,749
21-09-2014,38,52,45,611,746
22-09-2014,40,56,48,611,755
23-09-2014,41,59,50,611,761
24-09-2014,41,58,50,612,761
25-09-2014,40,56,48,612,756
26-09-2014,41,61,51,612,765
27-09-2014,42,52,47,612,753
28-09-2014,42,56,49,612,759
29-09-2014,40,54,47,613,754
30-09-2014,35,52,44,613,744
01-10-2014,37,53,45,613,748
02-10-2014,38,52,45,613,748
03-10-2014,36,52,44,614,746
04-10-2014,38,52,45,614,749
05-10-2014,40,52,46,614,752
06-10-2014,38,54,46,614,752
07-10-2014,42,53,48,615,758
08-10-2014,42,56,49,615,762
09-10-2014,42,60,51,615,768
10-10-2014,39,58,49,615,761
11-10-2014,39,54,47,616,756
12-10-2014,36,53,45,616,750
13-10-2014,33,53,43,616,745
14-10-2014,37,54,46,616,753
15-10-2014,39,58,49,617,763
16-10-2014,43,61,52,617,773
17-10-2014,44,51,48,617,760
18-10-2014,43,48,46,618,755
19-10-2014,42,54,48,618,762
20-10-2014,41,60,51,618,770
21-10-2014,38,59,49,619,765
22-10-2014,41,55,48,619,763
23-10-2014,36,56,46,620,758
24-10-2014,40,58,49,620,767
25-10-2014,39,58,49,620,766
26-10-2014,37,59,48,621,765
27-10-2014,39,55,47,621,762
28-10-2014,40,58,49,622,769
29-10-2014,41,57,49,622,769
30-10-2014,39,56,48,622,765
31-10-2014,37,56,47,623,763
01-11-2014,37,51,44,623,755
02-11-2014,41,54,48,624,767
03-11-2014,40,54,47,624,765
04-11-2014,37,48,43,625,753
05-11-2014,39,56,48,625,768
06-11-2014,43,56,50,626,775
07-11-2014,38,57,48,626,769
08-11-2014,36,55,46,627,764
09-11-2014,37,59,48,627,771
10-11-2014,42,60,51,628,781
11-11-2014,42,57,50,628,777
12-11-2014,41,56,49,629,775
13-11-2014,39,56,48,629,772
14-11-2014,38,54,46,630,768
15-11-2014,37,51,44,630,762
16-11-2014,38,55,47,631,771
17-11-2014,42,57,50,632,781
18-11-2014,38,56,47,632,773
19-11-2014,37,56,47,633,773
20-11-2014,39,51,45,633,768
21-11-2014,39,55,47,634,775
22-11-2014,38,54,46,635,773
23-11-2014,33,53,43,635,764
24-11-2014,41,59,50,636,786
25-11-2014,42,59,51,636,788
26-11-2014,41,55,48,637,781
27-11-2014,39,57,48,638,782
28-11-2014,38,56,47,638,779
29-11-2014,35,54,45,639,773
30-11-2014,35,50,43,640,768
01-12-2014,35,52,44,640,771
02-12-2014,35,51,43,641,770
03-12-2014,38,51,45,641,775
04-12-2014,42,52,47,642,783
05-12-2014,39,50,45,643,777
06-12-2014,36,51,44,643,774
07-12-2014,36,56,46,644,782
08-12-2014,38,58,48,645,789
09-12-2014,39,56,48,645,788
10-12-2014,39,60,50,646,795
11-12-2014,42,60,51,646,799
12-12-2014,37,55,46,647,785
13-12-2014,37,56,47,648,788
14-12-2014,38,56,47,648,789
15-12-2014,40,57,49,649,795
16-12-2014,40,57,49,649,795
17-12-2014,38,57,48,650,793
18-12-2014,40,56,48,650,794
19-12-2014,42,59,51,651,803
20-12-2014,39,56,48,651,794
21-12-2014,36,52,44,652,784
22-12-2014,31,47,39,652,769
23-12-2014,31,41,36,653,761
24-12-2014,36,45,41,653,775
25-12-2014,40,54,47,654,795
26-12-2014,41,53,47,654,795
27-12-2014,37,51,44,655,787
28-12-2014,39,56,48,655,798
29-12-2014,36,54,45,655,790
30-12-2014,36,53,45,656,790
31-12-2014,34,53,44,656,787
01-01-2015,38,51,45,657,791
02-01-2015,34,40,37,657,768
03-01-2015,29,36,33,657,755
04-01-2015,31,44,38,658,771
05-01-2015,37,51,44,658,790
06-01-2015,38,52,45,658,793
07-01-2015,38,54,46,658,796
08-01-2015,38,57,48,659,802
09-01-2015,36,55,46,659,796
10-01-2015,34,51,43,659,787
11-01-2015,38,54,46,659,797
12-01-2015,40,57,49,659,805
13-01-2015,41,56,49,659,805
14-01-2015,35,58,47,659,799
15-01-2015,38,58,48,659,803
16-01-2015,40,56,48,700,844
17-01-2015,38,58,48,700,844
18-01-2015,37,57,47,700,841
19-01-2015,37,59,48,700,844
20-01-2015,36,56,46,659,797
21-01-2015,40,58,49,659,806
22-01-2015,39,54,47,659,799
23-01-2015,43,65,54,659,821
24-01-2015,41,61,51,659,812
25-01-2015,40,55,48,659,802
26-01-2015,42,59,51,659,811
27-01-2015,36,58,47,659,800
28-01-2015,36,54,45,658,793
29-01-2015,35,54,45,658,792
30-01-2015,36,54,45,658,793
31-01-2015,33,53,43,658,787
01-02-2015,36,53,45,657,791
02-02-2015,38,54,46,657,795
03-02-2015,41,54,48,657,800
04-02-2015,39,50,45,656,790
05-02-2015,38,50,44,656,788
06-02-2015,33,47,40,655,775
07-02-2015,32,54,43,655,784
08-02-2015,43,59,51,655,808
09-02-2015,42,55,49,654,800
10-02-2015,35,50,43,654,782
11-02-2015,34,54,44,653,785
12-02-2015,37,53,45,653,788
13-02-2015,40,54,47,652,793
14-02-2015,38,57,48,652,795
15-02-2015,37,51,44,651,783
16-02-2015,37,53,45,651,786
17-02-2015,36,54,45,650,785
18-02-2015,36,54,45,649,784
19-02-2015,38,56,47,649,790
20-02-2015,39,54,47,648,788
21-02-2015,36,51,44,647,778
22-02-2015,35,52,44,647,778
23-02-2015,40,53,47,646,786
24-02-2015,40,56,48,646,790
25-02-2015,39,57,48,645,789
26-02-2015,36,48,42,644,770
27-02-2015,35,49,42,643,769
28-02-2015,35,44,40,643,762
01-03-2015,33,44,39,642,758
02-03-2015,32,43,38,641,754
03-03-2015,33,46,40,640,759
04-03-2015,33,39,36,640,748
05-03-2015,33,48,41,639,761
06-03-2015,35,49,42,638,764
07-03-2015,38,53,46,637,774
08-03-2015,32,46,39,637,754
09-03-2015,33,37,35,636,741
10-03-2015,34,42,38,635,749
11-03-2015,31,37,34,634,736
12-03-2015,32,39,36,633,740
13-03-2015,31,41,36,632,740
14-03-2015,31,47,39,632,749
15-03-2015,33,51,42,631,757
16-03-2015,36,54,45,630,765
17-03-2015,36,57,47,629,769
18-03-2015,36,57,47,628,768
19-03-2015,39,60,50,627,776
20-03-2015,38,61,50,626,775
21-03-2015,41,60,51,626,778
22-03-2015,37,56,47,625,765
23-03-2015,38,58,48,624,768
24-03-2015,36,56,46,623,761
25-03-2015,38,54,46,622,760
26-03-2015,34,59,47,621,761
27-03-2015,39,58,49,620,766
28-03-2015,42,58,50,620,770
29-03-2015,39,57,48,619,763
30-03-2015,36,54,45,618,753
31-03-2015,31,50,41,617,739
01-04-2015,32,49,41,616,738
02-04-2015,31,49,40,615,735
03-04-2015,35,50,43,614,742
04-04-2015,39,51,45,614,749
05-04-2015,35,53,44,613,745
06-04-2015,35,52,44,612,743
07-04-2015,33,47,40,611,731
08-04-2015,33,52,43,610,738
09-04-2015,34,51,43,610,738
10-04-2015,35,49,42,609,735
11-04-2015,35,48,42,608,733
12-04-2015,33,48,41,607,729
13-04-2015,36,53,45,606,740
14-04-2015,39,52,46,606,743
15-04-2015,37,48,43,605,733
16-04-2015,34,47,41,604,726
17-04-2015,34,50,42,603,729
18-04-2015,37,53,45,602,737
19-04-2015,40,58,49,602,749
20-04-2015,39,60,50,601,750
21-04-2015,43,63,53,600,759
22-04-2015,40,60,50,600,750
23-04-2015,39,57,48,559,703
24-04-2015,43,58,51,558,710
25-04-2015,43,57,50,558,708
26-04-2015,41,55,48,557,701
27-04-2015,37,54,46,556,693
28-04-2015,33,55,44,556,688
29-04-2015,37,59,48,555,699
30-04-2015,36,57,47,554,694
01-05-2015,37,53,45,554,689
02-05-2015,35,50,43,553,681
03-05-2015,33,53,43,553,682
04-05-2015,40,55,48,552,695
05-05-2015,42,59,51,552,704
06-05-2015,42,63,53,551,709
07-05-2015,41,59,50,550,700
08-05-2015,38,59,49,550,696
09-05-2015,38,54,46,550,688
10-05-2015,36,51,44,549,680
11-05-2015,37,55,46,549,687
12-05-2015,37,51,44,548,680
13-05-2015,33,45,39,548,665
14-05-2015,31,49,40,547,667
15-05-2015,32,52,42,547,673
16-05-2015,33,56,45,547,681
17-05-2015,38,60,49,546,693
18-05-2015,38,58,48,546,690
19-05-2015,39,55,47,546,687
20-05-2015,39,54,47,545,685
21-05-2015,37,55,46,545,683
22-05-2015,39,59,49,545,692
23-05-2015,41,55,48,545,689
24-05-2015,39,59,49,544,691
25-05-2015,42,62,52,544,700
26-05-2015,43,64,54,544,705
27-05-2015,44,57,51,544,696
28-05-2015,43,60,52,544,699
29-05-2015,44,62,53,543,702
30-05-2015,41,54,48,543,686
31-05-2015,39,52,46,543,680
01-06-2015,38,54,46,543,681
02-06-2015,41,56,49,543,689
03-06-2015,41,55,48,543,687
04-06-2015,39,55,47,543,684
05-06-2015,37,53,45,543,678
06-06-2015,36,55,46,543,680
07-06-2015,40,54,47,543,684
08-06-2015,38,56,47,543,684
09-06-2015,38,53,46,543,680
10-06-2015,37,49,43,543,672
11-06-2015,34,46,40,543,663
12-06-2015,32,50,41,543,666
13-06-2015,39,52,46,543,680
14-06-2015,42,57,50,544,693
15-06-2015,41,63,52,544,700
16-06-2015,48,61,55,544,708
17-06-2015,46,65,56,544,711
18-06-2015,45,67,56,544,712
19-06-2015,43,61,52,544,700
20-06-2015,43,60,52,545,700
21-06-2015,45,60,53,545,703
22-06-2015,45,59,52,545,701
23-06-2015,46,65,56,545,712
24-06-2015,42,60,51,545,698
25-06-2015,42,59,51,546,698
26-06-2015,42,57,50,546,695
27-06-2015,38,56,47,546,687
28-06-2015,42,55,49,546,692
29-06-2015,40,56,48,547,691
30-06-2015,40,56,48,547,691
01-07-2015,37,54,46,547,684
02-07-2015,38,54,46,548,686
03-07-2015,38,56,47,548,689
04-07-2015,39,56,48,548,691
05-07-2015,41,59,50,549,699
06-07-2015,43,60,52,549,704
07-07-2015,39,55,47,549,690
08-07-2015,40,53,47,550,690
09-07-2015,38,55,47,550,690
10-07-2015,40,55,48,550,693
11-07-2015,46,60,53,551,710
12-07-2015,46,58,52,551,707
13-07-2015,45,57,51,551,704
14-07-2015,45,60,53,552,710
15-07-2015,44,66,55,552,717
16-07-2015,43,59,51,553,706
17-07-2015,41,54,48,553,696
18-07-2015,39,56,48,553,696
19-07-2015,43,56,50,554,703
20-07-2015,40,51,46,554,691
21-07-2015,37,49,43,554,683
22-07-2015,37,52,45,555,689
23-07-2015,39,59,49,555,702
24-07-2015,43,59,51,556,709
25-07-2015,45,56,51,556,708
26-07-2015,42,58,50,556,706
27-07-2015,44,55,50,557,706
28-07-2015,40,55,48,557,700
29-07-2015,46,62,54,557,719
30-07-2015,48,64,56,558,726
31-07-2015,45,63,54,558,720
01-08-2015,46,66,56,558,726
02-08-2015,45,52,49,559,705
03-08-2015,44,51,48,559,702
04-08-2015,40,54,47,559,700
05-08-2015,43,56,50,600,749
06-08-2015,41,54,48,600,743
07-08-2015,41,59,50,600,750
08-08-2015,43,64,54,601,762
09-08-2015,43,63,53,601,760
10-08-2015,40,59,50,601,750
11-08-2015,39,55,47,602,743
12-08-2015,40,55,48,602,745
13-08-2015,40,56,48,602,746
14-08-2015,44,56,50,603,753
15-08-2015,41,53,47,603,744
16-08-2015,41,52,47,603,743
17-08-2015,42,53,48,603,746
18-08-2015,40,52,46,604,742
19-08-2015,39,52,46,604,741
20-08-2015,38,51,45,604,738
21-08-2015,42,65,54,604,765
22-08-2015,46,59,53,605,763
23-08-2015,45,57,51,605,758
24-08-2015,43,48,46,605,742
25-08-2015,42,52,47,605,746
26-08-2015,42,55,49,606,752
27-08-2015,41,57,49,606,753
28-08-2015,43,59,51,606,759
29-08-2015,42,59,51,606,758
30-08-2015,42,56,49,607,754
31-08-2015,41,55,48,607,751
01-09-2015,42,60,51,607,760
02-09-2015,43,52,48,607,750
03-09-2015,42,52,47,607,748
04-09-2015,40,53,47,608,748
05-09-2015,39,54,47,608,748
06-09-2015,41,54,48,608,751
07-09-2015,42,53,48,608,751
08-09-2015,41,59,50,608,758
09-09-2015,46,60,53,609,768
10-09-2015,42,56,49,609,756
11-09-2015,42,59,51,609,761
12-09-2015,41,56,49,609,755
13-09-2015,43,62,53,609,767
14-09-2015,42,62,52,610,766
15-09-2015,40,57,49,610,756
16-09-2015,39,54,47,610,750
17-09-2015,38,53,46,610,747
18-09-2015,38,54,46,610,748
19-09-2015,39,55,47,611,752
20-09-2015,41,58,50,611,760
21-09-2015,43,54,49,611,757
22-09-2015,39,54,47,611,751
23-09-2015,37,54,46,611,748
24-09-2015,38,55,47,612,752
25-09-2015,39,54,47,612,752
26-09-2015,42,53,48,612,755
27-09-2015,39,54,47,612,752
28-09-2015,39,53,46,612,750
29-09-2015,38,52,45,613,748
30-09-2015,39,60,50,613,762
01-10-2015,39,57,48,613,757
02-10-2015,39,57,48,613,757
03-10-2015,43,63,53,614,773
04-10-2015,45,57,51,614,767
05-10-2015,42,58,50,614,764
06-10-2015,39,54,47,614,754
07-10-2015,41,62,52,615,770
08-10-2015,41,60,51,615,767
09-10-2015,40,58,49,615,762
10-10-2015,41,56,49,615,761
11-10-2015,43,60,52,616,771
12-10-2015,40,58,49,616,763
13-10-2015,39,56,48,616,759
14-10-2015,38,58,48,616,760
15-10-2015,39,54,47,617,757
16-10-2015,42,60,51,617,770
17-10-2015,42,54,48,617,761
18-10-2015,40,58,49,618,765
19-10-2015,41,58,50,618,767
20-10-2015,40,57,49,618,764
21-10-2015,41,54,48,619,762
22-10-2015,40,55,48,619,762
23-10-2015,38,56,47,620,761
24-10-2015,42,57,50,620,769
25-10-2015,45,60,53,620,778
26-10-2015,44,63,54,621,782
27-10-2015,42,63,53,621,779
28-10-2015,44,57,51,622,774
29-10-2015,38,53,46,622,759
30-10-2015,42,54,48,622,766
31-10-2015,42,61,52,623,778
01-11-2015,41,57,49,623,770
02-11-2015,40,59,50,624,773
03-11-2015,43,57,50,624,774
04-11-2015,42,58,50,625,775
05-11-2015,40,60,50,625,775
06-11-2015,41,59,50,626,776
07-11-2015,42,60,51,626,779
08-11-2015,39,58,49,627,773
09-11-2015,37,52,45,627,761
10-11-2015,35,51,43,628,757
11-11-2015,37,53,45,628,763
12-11-2015,38,49,44,629,760
13-11-2015,37,49,43,629,758
14-11-2015,36,52,44,630,762
15-11-2015,36,51,44,630,761
16-11-2015,35,52,44,631,762
17-11-2015,37,56,47,632,772
18-11-2015,36,53,45,632,766
19-11-2015,43,56,50,633,782
20-11-2015,43,51,47,633,774
21-11-2015,41,53,47,634,775
22-11-2015,42,58,50,635,785
23-11-2015,42,55,49,635,781
24-11-2015,42,53,48,636,779
25-11-2015,38,55,47,636,776
26-11-2015,40,56,48,637,781
27-11-2015,41,58,50,638,787
28-11-2015,39,54,47,638,778
29-11-2015,40,58,49,639,786
30-11-2015,44,60,52,640,796
01-12-2015,43,60,52,640,795
02-12-2015,40,61,51,641,793
03-12-2015,42,57,50,641,790
04-12-2015,42,56,49,642,789
05-12-2015,39,58,49,643,789
06-12-2015,39,63,51,643,796
07-12-2015,45,63,54,644,806
08-12-2015,44,60,52,645,801
09-12-2015,41,56,49,645,791
10-12-2015,39,54,47,646,786
11-12-2015,42,53,48,646,789
12-12-2015,39,55,47,647,788
13-12-2015,36,52,44,648,780
14-12-2015,36,54,45,648,783
15-12-2015,33,49,41,649,772
16-12-2015,35,53,44,649,781
17-12-2015,37,54,46,650,787
18-12-2015,38,53,46,650,787
19-12-2015,34,46,40,651,771
20-12-2015,35,49,42,651,777
21-12-2015,35,47,41,652,775
22-12-2015,34,51,43,652,780
23-12-2015,33,46,40,653,772
24-12-2015,32,49,41,653,775
25-12-2015,35,48,42,654,779
26-12-2015,35,49,42,654,780
27-12-2015,35,50,43,655,783
28-12-2015,35,45,40,655,775
29-12-2015,31,49,40,655,775
30-12-2015,36,52,44,656,788
31-12-2015,40,56,48,656,800
01-01-2016,38,57,48,657,800
02-01-2016,35,54,45,657,791
03-01-2016,39,54,47,657,797
04-01-2016,37,53,45,658,793
05-01-2016,34,51,43,658,786
06-01-2016,36,56,46,658,796
07-01-2016,37,58,48,658,801
08-01-2016,37,54,46,659,796
09-01-2016,40,54,47,659,800
10-01-2016,39,53,46,659,797
11-01-2016,37,57,47,659,800
12-01-2016,39,54,47,659,799
13-01-2016,37,59,48,659,803
14-01-2016,40,60,50,659,809
15-01-2016,40,56,48,659,803
16-01-2016,38,54,46,700,838
17-01-2016,37,56,47,700,840
18-01-2016,41,55,48,700,844
19-01-2016,40,60,50,700,850
20-01-2016,42,58,50,659,809
21-01-2016,42,57,50,659,808
22-01-2016,41,59,50,659,809
23-01-2016,39,59,49,659,806
24-01-2016,38,55,47,659,799
25-01-2016,35,54,45,659,793
26-01-2016,39,58,49,659,805
27-01-2016,37,59,48,659,803
28-01-2016,44,62,53,658,817
29-01-2016,49,64,57,658,828
30-01-2016,45,62,54,658,819
31-01-2016,41,59,50,658,808
01-02-2016,36,54,45,657,792
02-02-2016,38,52,45,657,792
03-02-2016,38,55,47,657,797
04-02-2016,40,58,49,656,803
05-02-2016,37,58,48,656,799
06-02-2016,36,57,47,655,795
07-02-2016,33,47,40,655,775
08-02-2016,31,53,42,655,781
09-02-2016,37,53,45,654,789
10-02-2016,35,55,45,654,789
11-02-2016,38,54,46,653,791
12-02-2016,41,59,50,653,803
13-02-2016,43,60,52,652,807
14-02-2016,42,60,51,652,805
15-02-2016,38,58,48,651,795
16-02-2016,37,59,48,651,795
17-02-2016,44,57,51,650,802
18-02-2016,38,57,48,649,792
19-02-2016,36,57,47,649,789
20-02-2016,37,59,48,648,792
21-02-2016,39,61,50,647,797
22-02-2016,43,60,52,647,802
23-02-2016,45,63,54,646,808
24-02-2016,45,62,54,646,807
25-02-2016,39,53,46,645,783
26-02-2016,36,53,45,644,778
27-02-2016,36,59,48,643,786
28-02-2016,36,55,46,643,780
29-02-2016,37,60,49,642,788
01-03-2016,40,60,50,641,791
02-03-2016,39,61,50,640,790
03-03-2016,44,57,51,640,792
04-03-2016,42,58,50,639,789
05-03-2016,39,56,48,638,781
06-03-2016,37,60,49,637,783
07-03-2016,40,58,49,637,784
08-03-2016,43,66,55,636,800
09-03-2016,40,60,50,635,785
10-03-2016,37,57,47,634,775
11-03-2016,36,52,44,633,765
12-03-2016,36,54,45,632,767
13-03-2016,38,53,46,632,769
14-03-2016,40,54,47,631,772
15-03-2016,36,52,44,630,762
16-03-2016,38,51,45,629,763
17-03-2016,34,55,45,628,762
18-03-2016,35,53,44,627,759
19-03-2016,36,55,46,626,763
20-03-2016,38,54,46,626,764
21-03-2016,36,55,46,625,762
22-03-2016,35,52,44,624,755
23-03-2016,34,46,40,623,743
24-03-2016,33,47,40,622,742
25-03-2016,31,51,41,621,744
26-03-2016,34,50,42,620,746
27-03-2016,38,56,47,620,761
28-03-2016,42,60,51,619,772
29-03-2016,43,61,52,618,774
30-03-2016,42,60,51,617,770
31-03-2016,44,59,52,616,771
01-04-2016,42,57,50,615,764
02-04-2016,41,59,50,614,764
03-04-2016,42,62,52,614,770
04-04-2016,47,60,54,613,774
05-04-2016,44,61,53,612,770
06-04-2016,40,59,50,611,760
07-04-2016,36,60,48,610,754
08-04-2016,38,54,46,610,748
09-04-2016,40,56,48,609,753
10-04-2016,40,54,47,608,749
11-04-2016,41,60,51,607,759
12-04-2016,41,59,50,606,756
13-04-2016,39,59,49,606,753
14-04-2016,41,57,49,605,752
15-04-2016,36,53,45,604,738
16-04-2016,36,51,44,603,734
17-04-2016,36,53,45,602,736
18-04-2016,37,58,48,602,745
19-04-2016,38,54,46,601,739
21-04-2016,44,55,50,600,749
22-04-2016,44,56,50,559,709
23-04-2016,43,57,50,558,708
24-04-2016,42,59,51,558,710
25-04-2016,40,55,48,557,700
26-04-2016,42,57,50,556,705
27-04-2016,40,61,51,556,708
28-04-2016,43,57,50,555,705
29-04-2016,44,61,53,554,712
30-04-2016,39,57,48,554,698
01-05-2016,38,60,49,553,700
02-05-2016,45,63,54,553,715
03-05-2016,43,60,52,552,707
04-05-2016,44,65,55,552,716
05-05-2016,44,58,51,551,704
06-05-2016,41,56,49,550,696
07-05-2016,38,55,47,550,690
08-05-2016,40,53,47,550,690
09-05-2016,36,52,44,549,681
10-05-2016,34,52,43,549,678
11-05-2016,36,54,45,548,683
12-05-2016,37,53,45,548,683
13-05-2016,38,50,44,547,679
14-05-2016,39,61,50,547,697
15-05-2016,44,59,52,547,702
16-05-2016,43,60,52,546,701
17-05-2016,43,60,52,546,701
18-05-2016,43,58,51,546,698
19-05-2016,40,61,51,545,697
20-05-2016,41,57,49,545,692
21-05-2016,40,58,49,545,692
22-05-2016,38,56,47,545,686
23-05-2016,36,51,44,544,675
24-05-2016,33,51,42,544,670
25-05-2016,36,49,43,544,672
26-05-2016,36,52,44,544,676
27-05-2016,35,52,44,544,675
28-05-2016,39,51,45,543,678
29-05-2016,39,53,46,543,681
30-05-2016,38,55,47,543,683
31-05-2016,44,54,49,543,690
01-06-2016,41,54,48,543,686
02-06-2016,40,58,49,543,690
03-06-2016,41,56,49,543,689
04-06-2016,44,60,52,543,699
05-06-2016,45,58,52,543,698
06-06-2016,44,57,51,543,695
07-06-2016,44,59,52,543,698
08-06-2016,45,58,52,543,698
09-06-2016,46,60,53,543,702
10-06-2016,44,61,53,543,701
11-06-2016,40,54,47,543,684
12-06-2016,40,58,49,543,690
13-06-2016,40,58,49,544,691
14-06-2016,38,57,48,544,687
15-06-2016,40,55,48,544,687
16-06-2016,42,61,52,544,699
17-06-2016,46,60,53,544,703
18-06-2016,41,60,51,544,696
19-06-2016,42,60,51,545,698
20-06-2016,41,57,49,545,692
21-06-2016,39,56,48,545,688
22-06-2016,40,56,48,545,689
23-06-2016,42,56,49,545,692
24-06-2016,42,58,50,546,696
25-06-2016,43,56,50,546,695
26-06-2016,41,55,48,546,690
27-06-2016,37,53,45,546,681
28-06-2016,39,53,46,547,685
29-06-2016,38,54,46,547,685
30-06-2016,43,58,51,547,699
01-07-2016,39,57,48,548,692
02-07-2016,43,63,53,548,707
03-07-2016,45,67,56,548,716
04-07-2016,44,58,51,549,702
05-07-2016,40,54,47,549,690
06-07-2016,38,56,47,549,690
07-07-2016,43,61,52,550,706
08-07-2016,43,60,52,550,705
09-07-2016,42,56,49,550,697
10-07-2016,39,51,45,551,686
11-07-2016,36,50,43,551,680
12-07-2016,38,52,45,551,686
13-07-2016,36,54,45,552,687
14-07-2016,39,56,48,552,695
15-07-2016,42,57,50,553,702
16-07-2016,39,57,48,553,697
17-07-2016,40,54,47,553,694
18-07-2016,39,49,44,554,686
19-07-2016,38,52,45,554,689
20-07-2016,40,55,48,554,697
21-07-2016,41,62,52,555,710
22-07-2016,40,57,49,555,701
23-07-2016,43,52,48,556,699
24-07-2016,44,51,48,556,699
25-07-2016,42,58,50,556,706
26-07-2016,41,59,50,557,707
27-07-2016,39,57,48,557,701
28-07-2016,38,59,49,557,703
29-07-2016,37,58,48,558,701
30-07-2016,39,57,48,558,702
31-07-2016,41,55,48,558,702
01-08-2016,42,56,49,559,706
02-08-2016,40,58,49,559,706
03-08-2016,37,57,47,559,700
04-08-2016,40,58,49,600,747
05-08-2016,41,62,52,600,755
06-08-2016,37,59,48,600,744
07-08-2016,40,58,49,601,748
08-08-2016,42,60,51,601,754
09-08-2016,40,60,50,601,751
10-08-2016,42,62,52,602,758
11-08-2016,42,60,51,602,755
12-08-2016,44,61,53,602,760
13-08-2016,41,54,48,603,746
14-08-2016,42,53,48,603,746
15-08-2016,40,56,48,603,747
16-08-2016,39,56,48,603,746
17-08-2016,40,60,50,604,754
18-08-2016,42,59,51,604,756
19-08-2016,43,57,50,604,754
20-08-2016,37,59,48,604,748
21-08-2016,40,54,47,605,746
22-08-2016,44,49,47,605,745
23-08-2016,42,53,48,605,748
24-08-2016,41,53,47,605,746
25-08-2016,41,54,48,606,749
26-08-2016,41,58,50,606,755
27-08-2016,38,54,46,606,744
28-08-2016,35,53,44,606,738
29-08-2016,38,50,44,607,739
30-08-2016,37,58,48,607,750
31-08-2016,42,49,46,607,744
01-09-2016,40,54,47,607,748
02-09-2016,41,59,50,607,757
03-09-2016,41,52,47,608,748
04-09-2016,41,52,47,608,748
05-09-2016,40,55,48,608,751
06-09-2016,39,59,49,608,755
07-09-2016,37,55,46,608,746
08-09-2016,36,52,44,609,741
09-09-2016,38,55,47,609,749
10-09-2016,39,56,48,609,752
11-09-2016,37,56,47,609,749
12-09-2016,42,57,50,609,758
13-09-2016,42,57,50,610,759
14-09-2016,39,52,46,610,747
15-09-2016,38,46,42,610,736
16-09-2016,39,54,47,610,750
17-09-2016,42,55,49,610,756
18-09-2016,41,57,49,611,758
19-09-2016,42,60,51,611,764
20-09-2016,42,59,51,611,763
21-09-2016,44,59,52,611,766
22-09-2016,41,55,48,611,755
23-09-2016,40,55,48,612,755
24-09-2016,40,54,47,612,753
25-09-2016,38,55,47,612,752
26-09-2016,41,58,50,612,761
27-09-2016,37,50,44,612,743
28-09-2016,36,53,45,613,747
29-09-2016,36,59,48,613,756
30-09-2016,39,58,49,613,759
01-10-2016,39,56,48,613,756
02-10-2016,37,55,46,614,752
03-10-2016,38,49,44,614,745
04-10-2016,40,51,46,614,751
05-10-2016,37,53,45,614,749
06-10-2016,38,50,44,615,747
07-10-2016,36,52,44,615,747
08-10-2016,38,52,45,615,750
09-10-2016,35,55,45,615,750
10-10-2016,41,56,49,616,762
11-10-2016,40,56,48,616,760
12-10-2016,38,63,51,616,768
13-10-2016,42,62,52,616,772
14-10-2016,45,63,54,617,779
15-10-2016,45,64,55,617,781
16-10-2016,40,58,49,617,764
17-10-2016,39,58,49,618,764
18-10-2016,40,56,48,618,762
19-10-2016,39,57,48,618,762
20-10-2016,38,51,45,619,753
21-10-2016,38,55,47,619,759
22-10-2016,37,56,47,620,760
23-10-2016,42,62,52,620,776
24-10-2016,42,61,52,620,775
25-10-2016,38,56,47,621,762
26-10-2016,40,59,50,621,770
27-10-2016,40,58,49,622,769
28-10-2016,41,55,48,622,766
29-10-2016,38,54,46,622,760
30-10-2016,39,55,47,623,764
31-10-2016,40,56,48,623,767
01-11-2016,42,55,49,624,770
02-11-2016,38,58,48,624,768
03-11-2016,42,59,51,625,777
04-11-2016,40,58,49,625,772
05-11-2016,41,58,50,626,775
06-11-2016,38,59,49,626,772
07-11-2016,38,56,47,627,768
08-11-2016,38,53,46,627,764
09-11-2016,41,54,48,628,771
10-11-2016,43,54,49,628,774
11-11-2016,40,54,47,629,770
12-11-2016,36,54,45,629,764
13-11-2016,38,57,48,630,773
14-11-2016,41,57,49,630,777
15-11-2016,40,56,48,631,775
16-11-2016,41,54,48,632,775
17-11-2016,40,56,48,632,776
18-11-2016,40,57,49,633,779
19-11-2016,41,58,50,633,782
20-11-2016,41,54,48,634,777
21-11-2016,38,53,46,635,772
22-11-2016,36,52,44,635,767
23-11-2016,41,57,49,636,783
24-11-2016,39,55,47,636,777
25-11-2016,39,56,48,637,780
26-11-2016,42,57,50,638,787
27-11-2016,41,56,49,638,784
28-11-2016,38,54,46,639,777
29-11-2016,38,52,45,640,775
30-11-2016,34,46,40,640,760
01-12-2016,31,37,34,641,743
02-12-2016,32,38,35,641,746
03-12-2016,35,44,40,642,761
04-12-2016,37,44,41,643,765
05-12-2016,42,52,47,643,784
06-12-2016,40,52,46,644,782
07-12-2016,37,49,43,645,774
08-12-2016,40,51,46,645,782
09-12-2016,39,50,45,646,780
10-12-2016,39,43,41,646,769
11-12-2016,37,50,44,647,778
12-12-2016,36,49,43,648,776
13-12-2016,36,48,42,648,774
14-12-2016,36,53,45,649,783
15-12-2016,33,55,44,649,781
16-12-2016,34,44,39,650,767
17-12-2016,35,48,42,650,775
18-12-2016,33,41,37,651,762
19-12-2016,37,50,44,651,782
20-12-2016,38,51,45,652,786
21-12-2016,37,53,45,652,787
22-12-2016,38,56,47,653,794
23-12-2016,39,55,47,653,794
24-12-2016,37,56,47,654,794
25-12-2016,36,48,42,654,780
26-12-2016,35,49,42,655,781
27-12-2016,35,53,44,655,787
28-12-2016,35,51,43,655,784
29-12-2016,29,45,37,656,767
30-12-2016,33,45,39,656,773
31-12-2016,33,43,38,657,771
01-01-2017,31,46,39,657,773
02-01-2017,34,52,43,657,786
03-01-2017,35,51,43,657,786
04-01-2017,34,50,42,658,784
05-01-2017,33,46,40,658,777
06-01-2017,34,48,41,658,781
07-01-2017,33,48,41,658,780
08-01-2017,33,52,43,659,787
09-01-2017,39,55,47,659,800
10-01-2017,36,53,45,659,793
11-01-2017,34,50,42,659,785
12-01-2017,29,49,39,659,776
13-01-2017,34,52,43,659,788
14-01-2017,37,50,44,659,790
15-01-2017,35,55,45,659,794
16-01-2017,38,51,45,700,834
17-01-2017,39,54,47,700,840
18-01-2017,38,54,46,700,838
19-01-2017,43,57,50,700,850
20-01-2017,41,61,51,659,812
21-01-2017,36,54,45,659,794
22-01-2017,34,49,42,659,784
23-01-2017,31,48,40,659,778
24-01-2017,30,45,38,659,772
25-01-2017,29,50,40,659,778
26-01-2017,38,54,46,659,797
27-01-2017,42,59,51,659,811
28-01-2017,36,55,46,658,795
29-01-2017,34,52,43,658,787
30-01-2017,31,49,40,658,778
31-01-2017,33,52,43,658,786
01-02-2017,32,48,40,657,777
02-02-2017,31,51,41,657,780
03-02-2017,34,47,41,657,779
04-02-2017,33,52,43,656,784
05-02-2017,40,57,49,656,802
06-02-2017,41,55,48,655,799
07-02-2017,38,51,45,655,789
08-02-2017,38,54,46,655,793
09-02-2017,40,55,48,654,797
10-02-2017,44,56,50,654,804
11-02-2017,33,53,43,653,782
12-02-2017,32,53,43,653,781
13-02-2017,38,56,47,652,793
14-02-2017,41,58,50,652,801
15-02-2017,41,56,49,651,797
16-02-2017,37,57,47,651,792
17-02-2017,40,57,49,650,796
18-02-2017,37,52,45,649,783
19-02-2017,32,47,40,649,768
20-02-2017,28,46,37,648,759
21-02-2017,25,40,33,647,745
22-02-2017,27,42,35,647,751
23-02-2017,25,42,34,646,747
24-02-2017,25,45,35,646,751
25-02-2017,31,47,39,645,762
26-02-2017,36,43,40,644,763
27-02-2017,33,43,38,643,757
28-02-2017,34,43,39,643,759
01-03-2017,33,44,39,642,758
02-03-2017,34,48,41,641,764
03-03-2017,34,52,43,640,769
04-03-2017,33,53,43,640,769
05-03-2017,36,51,44,639,770
06-03-2017,34,50,42,638,764
07-03-2017,34,52,43,637,766
08-03-2017,36,49,43,637,765
09-03-2017,35,46,41,636,758
10-03-2017,33,48,41,635,757
11-03-2017,31,42,37,634,744
12-03-2017,31,45,38,633,747
13-03-2017,34,50,42,632,758
14-03-2017,35,54,45,632,766
15-03-2017,38,56,47,631,772
16-03-2017,35,55,45,630,765
17-03-2017,36,56,46,629,767
18-03-2017,39,59,49,628,775
19-03-2017,40,55,48,627,770
20-03-2017,38,56,47,626,767
21-03-2017,39,60,50,626,775
22-03-2017,41,61,51,625,778
23-03-2017,36,51,44,624,755
24-03-2017,38,58,48,623,767
25-03-2017,35,56,46,622,759
26-03-2017,35,57,46,621,759
27-03-2017,39,59,49,620,767
28-03-2017,40,56,48,620,764
29-03-2017,41,58,50,619,768
30-03-2017,37,56,47,618,758
31-03-2017,39,53,46,617,755
01-04-2017,35,54,45,616,750
02-04-2017,36,54,45,615,750
03-04-2017,38,55,47,614,754
04-04-2017,41,61,51,614,767
05-04-2017,46,64,55,613,778
06-04-2017,45,62,54,612,773
07-04-2017,46,63,55,611,775
08-04-2017,42,64,53,610,769
09-04-2017,41,57,49,610,757
10-04-2017,38,53,46,609,746
11-04-2017,36,56,46,608,746
12-04-2017,34,48,41,607,730
13-04-2017,36,55,46,606,743
14-04-2017,34,47,41,606,728
15-04-2017,34,51,43,605,733
16-04-2017,37,53,45,604,739
17-04-2017,35,54,45,603,737
18-04-2017,36,52,44,602,734
20-04-2017,35,53,44,601,733
21-04-2017,35,56,46,600,737
22-04-2017,38,61,50,600,749
23-04-2017,39,55,47,559,700
24-04-2017,38,55,47,558,698
25-04-2017,40,60,50,558,708
26-04-2017,44,59,52,557,712
27-04-2017,42,58,50,556,706
28-04-2017,35,53,44,556,688
29-04-2017,36,50,43,555,684
30-04-2017,35,44,40,554,673
01-05-2017,35,46,41,554,676
02-05-2017,35,49,42,553,679
03-05-2017,36,47,42,553,678
04-05-2017,38,60,49,552,699
05-05-2017,38,60,49,552,699
06-05-2017,40,61,51,551,703
07-05-2017,39,56,48,550,693
08-05-2017,38,57,48,550,693
09-05-2017,36,56,46,550,688
10-05-2017,35,53,44,549,681
11-05-2017,36,50,43,549,678
12-05-2017,37,58,48,548,691
13-05-2017,38,55,47,548,688
14-05-2017,36,55,46,547,684
15-05-2017,34,53,44,547,678
16-05-2017,35,53,44,547,679
17-05-2017,34,53,44,546,677
18-05-2017,35,49,42,546,672
19-05-2017,35,51,43,546,675
20-05-2017,39,57,48,545,689
21-05-2017,43,56,50,545,694
22-05-2017,43,63,53,545,704
23-05-2017,43,65,54,545,707
24-05-2017,42,53,48,544,687
25-05-2017,38,53,46,544,681
26-05-2017,35,50,43,544,672
27-05-2017,33,48,41,544,666
28-05-2017,32,49,41,544,666
29-05-2017,38,53,46,543,680
30-05-2017,36,56,46,543,681
31-05-2017,43,58,51,543,695
01-06-2017,45,62,54,543,704
02-06-2017,44,64,54,543,705
03-06-2017,44,63,54,543,704
04-06-2017,44,63,54,543,704
05-06-2017,43,59,51,543,696
06-06-2017,42,60,51,543,696
07-06-2017,43,62,53,543,701
08-06-2017,47,64,56,543,710
09-06-2017,46,66,56,543,711
10-06-2017,43,62,53,543,701
11-06-2017,41,61,51,543,696
12-06-2017,42,58,50,543,693
13-06-2017,40,60,50,543,693
14-06-2017,39,57,48,544,688
15-06-2017,39,55,47,544,685
16-06-2017,40,58,49,544,691
17-06-2017,42,59,51,544,696
18-06-2017,46,60,53,544,703
19-06-2017,46,65,56,544,711
20-06-2017,47,64,56,545,712
21-06-2017,47,62,55,545,709
22-06-2017,46,61,54,545,706
23-06-2017,45,57,51,545,698
24-06-2017,45,62,54,545,706
25-06-2017,44,57,51,546,698
26-06-2017,40,62,51,546,699
27-06-2017,45,63,54,546,708
28-06-2017,41,56,49,546,692
29-06-2017,42,61,52,547,702
30-06-2017,44,61,53,547,705
01-07-2017,40,57,49,547,693
02-07-2017,39,54,47,548,688
03-07-2017,42,59,51,548,700
04-07-2017,40,56,48,548,692
05-07-2017,40,56,48,549,693
06-07-2017,41,57,49,549,696
07-07-2017,40,59,50,549,698
08-07-2017,39,58,49,550,696
09-07-2017,40,54,47,550,691
10-07-2017,38,53,46,550,687
11-07-2017,39,55,47,551,692
12-07-2017,40,57,49,551,697
13-07-2017,39,58,49,551,697
14-07-2017,38,54,46,552,690
15-07-2017,36,52,44,552,684
16-07-2017,42,58,50,553,703
17-07-2017,42,57,50,553,702
18-07-2017,41,53,47,553,694
19-07-2017,40,59,50,554,703
20-07-2017,41,61,51,554,707
21-07-2017,40,60,50,554,704
22-07-2017,42,60,51,555,708
23-07-2017,40,62,51,555,708
24-07-2017,42,53,48,556,699
25-07-2017,40,58,49,556,703
26-07-2017,38,58,48,556,700
27-07-2017,43,59,51,557,710
28-07-2017,44,60,52,557,713
29-07-2017,41,57,49,557,704
30-07-2017,44,61,53,558,716
31-07-2017,44,63,54,558,719
01-08-2017,42,56,49,558,705
02-08-2017,39,54,47,559,699
03-08-2017,40,54,47,559,700
04-08-2017,42,63,53,559,717
05-08-2017,45,65,55,600,765
06-08-2017,43,58,51,600,752
07-08-2017,43,58,51,600,752
08-08-2017,42,59,51,601,753
09-08-2017,42,58,50,601,751
10-08-2017,41,59,50,601,751
11-08-2017,45,63,54,602,764
12-08-2017,47,66,57,602,772
13-08-2017,45,62,54,602,763
14-08-2017,43,58,51,603,755
15-08-2017,43,59,51,603,756
16-08-2017,43,58,51,603,755
17-08-2017,41,58,50,603,752
18-08-2017,42,60,51,604,757
19-08-2017,39,56,48,604,747
20-08-2017,40,55,48,604,747
21-08-2017,38,49,44,604,735
22-08-2017,40,57,49,605,751
23-08-2017,44,59,52,605,760
24-08-2017,44,62,53,605,764
25-08-2017,44,61,53,605,763
26-08-2017,41,58,50,606,755
27-08-2017,40,58,49,606,753
28-08-2017,38,55,47,606,746
29-08-2017,39,52,46,606,743
30-08-2017,37,54,46,607,744
31-08-2017,40,59,50,607,756
01-09-2017,44,63,54,607,768
02-09-2017,40,56,48,607,751
03-09-2017,42,59,51,607,759
04-09-2017,40,58,49,608,755
05-09-2017,40,58,49,608,755
06-09-2017,41,55,48,608,752
07-09-2017,37,53,45,608,743
08-09-2017,39,53,46,608,746
09-09-2017,38,51,45,609,743
10-09-2017,39,53,46,609,747
11-09-2017,41,55,48,609,753
12-09-2017,42,58,50,609,759
13-09-2017,43,56,50,609,758
14-09-2017,43,59,51,610,763
15-09-2017,42,60,51,610,763
16-09-2017,42,60,51,610,763
17-09-2017,45,64,55,610,774
18-09-2017,42,60,51,610,763
19-09-2017,39,57,48,611,755
20-09-2017,38,50,44,611,743
21-09-2017,39,53,46,611,749
22-09-2017,37,50,44,611,742
23-09-2017,39,54,47,611,751
24-09-2017,35,54,45,612,746
25-09-2017,39,56,48,612,755
26-09-2017,37,56,47,612,752
27-09-2017,39,58,49,612,758
28-09-2017,40,60,50,612,762
29-09-2017,41,60,51,613,765
30-09-2017,36,51,44,613,744
01-10-2017,37,53,45,613,748
02-10-2017,38,54,46,613,751
03-10-2017,39,56,48,614,757
04-10-2017,40,60,50,614,764
05-10-2017,42,60,51,614,767
06-10-2017,43,58,51,614,766
07-10-2017,41,55,48,615,759
08-10-2017,42,58,50,615,765
09-10-2017,48,59,54,615,776
10-10-2017,44,59,52,615,770
11-10-2017,44,57,51,616,768
12-10-2017,41,57,49,616,763
13-10-2017,39,53,46,616,754
14-10-2017,37,54,46,616,753
15-10-2017,39,51,45,617,752
16-10-2017,38,57,48,617,760
17-10-2017,40,57,49,617,763
18-10-2017,44,60,52,618,774
19-10-2017,42,59,51,618,770
20-10-2017,39,54,47,618,758
21-10-2017,39,57,48,619,763
22-10-2017,38,53,46,619,756
23-10-2017,38,55,47,620,760
24-10-2017,44,54,49,620,767
25-10-2017,44,52,48,620,764
26-10-2017,42,60,51,621,774
27-10-2017,40,60,50,621,771
28-10-2017,42,59,51,622,774
29-10-2017,40,55,48,622,765
30-10-2017,39,53,46,622,760
31-10-2017,37,51,44,623,755
01-11-2017,37,54,46,623,760
02-11-2017,37,56,47,624,764
03-11-2017,41,57,49,624,771
04-11-2017,41,55,48,625,769
05-11-2017,41,58,50,625,774
06-11-2017,44,61,53,626,784
07-11-2017,42,62,52,626,782
08-11-2017,42,60,51,627,780
09-11-2017,40,58,49,627,774
10-11-2017,39,57,48,628,772
11-11-2017,39,53,46,628,766
12-11-2017,36,47,42,629,754
13-11-2017,35,49,42,629,755
14-11-2017,36,50,43,630,759
15-11-2017,36,50,43,630,759
16-11-2017,34,48,41,631,754
17-11-2017,35,51,43,632,761
18-11-2017,36,50,43,632,761
19-11-2017,36,47,42,633,758
20-11-2017,34,50,42,633,759
21-11-2017,34,48,41,634,757
22-11-2017,33,48,41,635,757
23-11-2017,31,47,39,635,752
24-11-2017,35,50,43,636,764
25-11-2017,33,47,40,636,756
26-11-2017,33,48,41,637,759
27-11-2017,35,45,40,638,758
28-11-2017,40,47,44,638,769
29-11-2017,39,49,44,639,771
30-11-2017,39,47,43,640,769
01-12-2017,39,49,44,640,772
02-12-2017,34,46,40,641,761
03-12-2017,35,50,43,641,769
04-12-2017,36,53,45,642,776
05-12-2017,32,49,41,643,765
06-12-2017,33,47,40,643,763
07-12-2017,34,50,42,644,770
08-12-2017,33,53,43,645,774
09-12-2017,37,58,48,645,788
10-12-2017,35,52,44,646,777
11-12-2017,34,54,44,646,778
12-12-2017,35,56,46,647,784
13-12-2017,32,45,39,648,764
14-12-2017,30,45,38,648,761
15-12-2017,31,44,38,649,762
16-12-2017,32,49,41,649,771
17-12-2017,36,52,44,650,782
18-12-2017,36,49,43,650,778
19-12-2017,35,43,39,651,768
20-12-2017,33,38,36,651,758
21-12-2017,32,39,36,652,759
22-12-2017,31,49,40,652,772
23-12-2017,36,50,43,653,782
24-12-2017,36,54,45,653,788
25-12-2017,34,50,42,654,780
26-12-2017,35,53,44,654,786
27-12-2017,37,53,45,655,790
28-12-2017,36,49,43,655,783
29-12-2017,33,52,43,655,783
30-12-2017,36,52,44,656,788
31-12-2017,34,54,44,656,788
01-01-2018,35,52,44,657,788
02-01-2018,32,56,44,657,789
03-01-2018,35,49,42,657,783
04-01-2018,39,55,47,658,799
05-01-2018,38,55,47,658,798
06-01-2018,39,58,49,658,804
07-01-2018,38,54,46,658,796
08-01-2018,40,53,47,659,799
09-01-2018,34,50,42,659,785
10-01-2018,31,47,39,659,776
11-01-2018,31,46,39,659,775
12-01-2018,32,52,42,659,785
13-01-2018,37,53,45,659,794
14-01-2018,37,54,46,659,796
15-01-2018,36,54,45,659,794
16-01-2018,38,55,47,700,840
17-01-2018,37,57,47,700,841
18-01-2018,36,54,45,700,835
19-01-2018,37,54,46,700,837
20-01-2018,33,50,42,659,784
21-01-2018,34,48,41,659,782
22-01-2018,33,48,41,659,781
23-01-2018,33,47,40,659,779
24-01-2018,34,47,41,659,781
25-01-2018,34,46,40,659,779
26-01-2018,34,43,39,659,775
27-01-2018,35,43,39,659,776
28-01-2018,33,43,38,658,772
29-01-2018,31,46,39,658,774
30-01-2018,34,50,42,658,784
31-01-2018,33,46,40,658,777
01-02-2018,35,51,43,657,786
02-02-2018,37,50,44,657,788
03-02-2018,37,50,44,657,788
04-02-2018,34,49,42,656,781
05-02-2018,32,48,40,656,776
06-02-2018,31,41,36,655,763
07-02-2018,28,42,35,655,760
08-02-2018,30,45,38,655,768
09-02-2018,29,45,37,654,765
10-02-2018,31,46,39,654,770
11-02-2018,35,49,42,653,779
12-02-2018,36,52,44,653,785
13-02-2018,40,55,48,652,795
14-02-2018,41,55,48,652,796
15-02-2018,39,56,48,651,794
16-02-2018,38,55,47,651,791
17-02-2018,34,42,38,650,764
18-02-2018,33,47,40,649,769
19-02-2018,31,43,37,649,760
20-02-2018,31,47,39,648,765
21-02-2018,38,43,41,647,769
22-02-2018,35,41,38,647,761
23-02-2018,35,45,40,646,766
24-02-2018,37,49,43,646,775
25-02-2018,38,46,42,645,771
26-02-2018,37,49,43,644,773
27-02-2018,36,51,44,643,774
28-02-2018,39,56,48,643,786
01-03-2018,40,53,47,642,782
02-03-2018,40,54,47,641,782
03-03-2018,40,52,46,640,778
04-03-2018,38,54,46,640,778
05-03-2018,34,46,40,639,759
06-03-2018,31,46,39,638,754
07-03-2018,30,44,37,637,748
08-03-2018,31,44,38,637,750
09-03-2018,33,46,40,636,755
10-03-2018,35,49,42,635,761
11-03-2018,35,52,44,634,765
12-03-2018,39,44,42,633,758
13-03-2018,38,44,41,632,755
14-03-2018,39,48,44,632,763
15-03-2018,36,47,42,631,756
16-03-2018,36,47,42,630,755
17-03-2018,38,49,44,629,760
18-03-2018,36,52,44,628,760
19-03-2018,35,48,42,627,752
20-03-2018,35,45,40,626,746
21-03-2018,37,46,42,626,751
22-03-2018,36,45,41,625,747
23-03-2018,38,50,44,624,756
24-03-2018,33,42,38,623,736
25-03-2018,35,49,42,622,748
26-03-2018,34,45,40,621,740
27-03-2018,33,53,43,620,749
28-03-2018,35,55,45,620,755
29-03-2018,35,52,44,619,750
30-03-2018,33,53,43,618,747
31-03-2018,34,47,41,617,739
01-04-2018,34,52,43,616,745
02-04-2018,41,53,47,615,756
03-04-2018,41,51,46,614,752
04-04-2018,44,58,51,614,767
05-04-2018,42,55,49,613,759
06-04-2018,41,54,48,612,755
07-04-2018,40,48,44,611,743
08-04-2018,38,50,44,610,742
09-04-2018,39,47,43,610,739
10-04-2018,39,53,46,609,747
11-04-2018,37,54,46,608,745
12-04-2018,37,53,45,607,742
13-04-2018,34,49,42,606,731
14-04-2018,34,51,43,606,734
15-04-2018,35,47,41,605,728
16-04-2018,39,49,44,604,736
17-04-2018,37,53,45,603,738
18-04-2018,38,57,48,602,745
19-04-2018,37,49,43,602,731
20-04-2018,35,42,39,601,717
21-04-2018,37,51,44,600,732
22-04-2018,37,58,48,600,743
23-04-2018,40,60,50,559,709
24-04-2018,38,56,47,558,699
25-04-2018,35,50,43,558,686
26-04-2018,37,51,44,557,689
27-04-2018,37,53,45,556,691
28-04-2018,38,53,46,556,693
29-04-2018,40,59,50,555,704
30-04-2018,43,53,48,554,698
01-05-2018,43,54,49,554,700
02-05-2018,42,50,46,553,691
03-05-2018,41,54,48,553,696
04-05-2018,38,54,46,552,690
05-05-2018,38,57,48,552,695
06-05-2018,42,54,48,551,695
07-05-2018,42,55,49,550,696
08-05-2018,42,55,49,550,696
09-05-2018,42,57,50,550,699
10-05-2018,41,55,48,549,693
11-05-2018,37,54,46,549,686
12-05-2018,36,54,45,548,683
13-05-2018,34,53,44,548,679
14-05-2018,36,52,44,547,679
15-05-2018,39,52,46,547,684
16-05-2018,36,52,44,547,679
17-05-2018,38,50,44,546,678
18-05-2018,37,54,46,546,683
19-05-2018,41,59,50,546,696
20-05-2018,40,59,50,545,694
21-05-2018,42,55,49,545,691
22-05-2018,41,59,50,545,695
23-05-2018,43,61,52,545,701
24-05-2018,46,66,56,544,712
25-05-2018,47,62,55,544,708
26-05-2018,47,64,56,544,711
27-05-2018,45,60,53,544,702
28-05-2018,41,58,50,544,693
29-05-2018,44,50,47,543,684
30-05-2018,43,60,52,543,698
31-05-2018,45,65,55,543,708
01-06-2018,47,58,53,543,701
02-06-2018,45,63,54,543,705
03-06-2018,46,65,56,543,710
04-06-2018,46,64,55,543,708
05-06-2018,44,59,52,543,698
06-06-2018,39,53,46,543,681
07-06-2018,40,57,49,543,689
08-06-2018,38,56,47,543,684
09-06-2018,41,59,50,543,693
10-06-2018,40,57,49,543,689
11-06-2018,39,57,48,543,687
12-06-2018,38,52,45,543,678
13-06-2018,39,53,46,543,681
14-06-2018,38,55,47,544,684
15-06-2018,40,53,47,544,684
16-06-2018,37,55,46,544,682
17-06-2018,43,59,51,544,697
18-06-2018,44,58,51,544,697
19-06-2018,42,59,51,544,696
20-06-2018,45,61,53,545,704
21-06-2018,44,59,52,545,700
22-06-2018,44,60,52,545,701
23-06-2018,44,61,53,545,703
24-06-2018,42,60,51,545,698
25-06-2018,40,57,49,546,692
26-06-2018,40,57,49,546,692
27-06-2018,39,60,50,546,695
28-06-2018,42,60,51,546,699
29-06-2018,39,55,47,547,688
30-06-2018,41,58,50,547,696
01-07-2018,40,52,46,547,685
02-07-2018,40,48,44,548,680
03-07-2018,39,52,46,548,685
04-07-2018,40,54,47,548,689
05-07-2018,39,63,51,549,702
06-07-2018,41,60,51,549,701
07-07-2018,39,55,47,549,690
08-07-2018,39,53,46,550,688
09-07-2018,36,50,43,550,679
10-07-2018,37,56,47,550,690
11-07-2018,43,59,51,551,704
12-07-2018,45,57,51,551,704
13-07-2018,45,61,53,551,710
14-07-2018,42,55,49,552,698
15-07-2018,42,54,48,552,696
16-07-2018,41,63,52,553,709
17-07-2018,44,62,53,553,712
18-07-2018,42,59,51,553,705
19-07-2018,41,58,50,554,703
20-07-2018,40,59,50,554,703
21-07-2018,45,61,53,554,713
22-07-2018,44,63,54,555,716
23-07-2018,45,61,53,555,714
24-07-2018,43,58,51,556,708
25-07-2018,42,57,50,556,705
26-07-2018,43,56,50,556,705
27-07-2018,43,59,51,557,710
28-07-2018,44,61,53,557,715
29-07-2018,47,58,53,557,715
30-07-2018,42,55,49,558,704
31-07-2018,40,59,50,558,707
01-08-2018,40,60,50,558,708
02-08-2018,38,56,47,559,700
03-08-2018,40,57,49,559,705
04-08-2018,41,61,51,559,712
05-08-2018,45,65,55,600,765
06-08-2018,46,65,56,600,767
07-08-2018,46,64,55,600,765
08-08-2018,44,54,49,601,748
09-08-2018,45,58,52,601,756
10-08-2018,41,56,49,601,747
11-08-2018,40,57,49,602,748
12-08-2018,40,60,50,602,752
13-08-2018,42,58,50,602,752
14-08-2018,39,55,47,603,744
15-08-2018,40,55,48,603,746
16-08-2018,40,53,47,603,743
17-08-2018,40,54,47,603,744
18-08-2018,41,60,51,604,756
19-08-2018,41,58,50,604,753
20-08-2018,41,58,50,604,753
21-08-2018,41,58,50,604,753
22-08-2018,42,51,47,605,745
23-08-2018,44,48,46,605,743
24-08-2018,45,54,50,605,754
25-08-2018,44,55,50,605,754
26-08-2018,43,49,46,606,744
27-08-2018,42,49,46,606,743
28-08-2018,40,50,45,606,741
29-08-2018,42,54,48,606,750
30-08-2018,40,54,47,607,748
31-08-2018,38,54,46,607,745
01-09-2018,39,55,47,607,748
02-09-2018,40,56,48,607,751
03-09-2018,41,58,50,607,756
04-09-2018,39,59,49,608,755
05-09-2018,40,59,50,608,757
06-09-2018,37,55,46,608,746
07-09-2018,38,53,46,608,745
08-09-2018,38,53,46,608,745
09-09-2018,39,54,47,609,749
10-09-2018,37,56,47,609,749
11-09-2018,41,58,50,609,758
12-09-2018,42,52,47,609,750
13-09-2018,40,51,46,609,746
14-09-2018,36,55,46,610,747
15-09-2018,39,54,47,610,750
16-09-2018,39,56,48,610,753
17-09-2018,41,57,49,610,757
18-09-2018,40,54,47,610,751
19-09-2018,43,57,50,611,761
20-09-2018,41,57,49,611,758
21-09-2018,42,60,51,611,764
22-09-2018,44,63,54,611,772
23-09-2018,46,61,54,611,772
24-09-2018,41,60,51,612,764
25-09-2018,41,56,49,612,758
26-09-2018,40,54,47,612,753
27-09-2018,40,56,48,612,756
28-09-2018,43,59,51,612,765
29-09-2018,43,61,52,613,769
30-09-2018,43,62,53,613,771
01-10-2018,40,63,52,613,768
02-10-2018,41,56,49,613,759
03-10-2018,40,59,50,614,763
04-10-2018,43,58,51,614,766
05-10-2018,42,56,49,614,761
06-10-2018,40,51,46,614,751
07-10-2018,42,51,47,615,755
08-10-2018,42,52,47,615,756
09-10-2018,40,52,46,615,753
10-10-2018,39,51,45,615,750
11-10-2018,39,53,46,616,754
12-10-2018,38,54,46,616,754
13-10-2018,41,54,48,616,759
14-10-2018,39,56,48,616,759
15-10-2018,38,52,45,617,752
16-10-2018,40,55,48,617,760
17-10-2018,37,52,45,617,751
18-10-2018,37,51,44,618,750
20-10-2018,38,48,43,618,747
21-10-2018,36,47,42,619,744
22-10-2018,35,52,44,619,750
23-10-2018,37,52,45,620,754
24-10-2018,40,54,47,620,761
25-10-2018,38,56,47,620,761
26-10-2018,37,53,45,621,756
27-10-2018,38,52,45,621,756
28-10-2018,41,52,47,622,762
29-10-2018,38,53,46,622,759
30-10-2018,44,53,49,622,768
31-10-2018,43,55,49,623,770
01-11-2018,41,57,49,623,770
02-11-2018,35,52,44,624,755
03-11-2018,34,46,40,624,744
04-11-2018,33,46,40,625,744
05-11-2018,35,51,43,625,754
06-11-2018,32,48,40,626,746
07-11-2018,35,48,42,626,751
08-11-2018,33,51,42,627,753
09-11-2018,37,52,45,627,761
10-11-2018,39,53,46,628,766
11-11-2018,34,52,43,628,757
12-11-2018,33,56,45,629,763
13-11-2018,37,55,46,629,767
14-11-2018,38,56,47,630,771
15-11-2018,38,53,46,630,767
16-11-2018,40,52,46,631,769
17-11-2018,40,52,46,632,770
18-11-2018,37,51,44,632,764
19-11-2018,35,51,43,633,762
20-11-2018,35,54,45,633,767
21-11-2018,34,54,44,634,766
22-11-2018,32,50,41,635,758
23-11-2018,33,51,42,635,761
24-11-2018,41,54,48,636,779
25-11-2018,38,57,48,636,779
26-11-2018,41,56,49,637,783
27-11-2018,40,57,49,638,784
28-11-2018,42,56,49,638,785
29-11-2018,38,57,48,639,782
30-11-2018,38,52,45,640,775
01-12-2018,36,52,44,640,772
02-12-2018,33,51,42,641,767
03-12-2018,36,53,45,641,775
04-12-2018,39,56,48,642,785
05-12-2018,36,53,45,643,777
06-12-2018,36,52,44,643,775
07-12-2018,37,53,45,644,779
08-12-2018,34,53,44,645,776
09-12-2018,36,53,45,645,779
10-12-2018,36,55,46,646,783
11-12-2018,38,56,47,646,787
12-12-2018,39,54,47,647,787
13-12-2018,36,54,45,648,783
14-12-2018,36,56,46,648,786
15-12-2018,40,53,47,649,789
16-12-2018,40,57,49,649,795
17-12-2018,42,60,51,650,803
18-12-2018,35,51,43,650,779
19-12-2018,32,51,42,651,776
20-12-2018,37,58,48,651,794
21-12-2018,42,57,50,652,801
22-12-2018,40,54,47,652,793
23-12-2018,39,55,47,653,794
24-12-2018,36,52,44,653,785
25-12-2018,36,48,42,654,780
26-12-2018,35,45,40,654,774
27-12-2018,33,44,39,655,771
28-12-2018,33,47,40,655,775
29-12-2018,36,47,42,655,780
30-12-2018,39,52,46,656,793
